Û,Û,Û,Û,Û,Û,Û,Û,Û,Û,Û,Û,Û,Û,Û,Û,Û,Û,Û,Û,Û,Û,Û,Û,Û,Û,Û,Û,Û,Û,Û,Û,Û,Û,Û
Û, , , , , ,Û, ,Û, ,Û, ,Û, , , , , ,Û, , , ,Û, , , , , ,Û, , , , , ,Û
Û, ,Û, ,Û,Û,Û, ,Û, ,Û, ,Û, ,Û,Û,Û,Û,Û, ,Û,Û,Û, ,Û,Û,Û,Û,Û, ,Û,Û,Û,Û,Û
Û, ,Û, , , ,Û, ,Û, ,Û, ,Û, , , , , ,Û, ,Û, ,Û, ,Û, , , , , , , , , ,Û
Û,Û,Û, ,Û,Û,Û, ,Û, ,Û, ,Û, ,Û,Û,Û,Û,Û, ,Û, ,Û, ,Û, ,Û,Û,Û, ,Û, ,Û,Û,Û
Û, ,Û, , , , , , , , , , , , , , , , , , , ,Û, ,Û, ,Û, , , ,Û, ,Û, ,Û
Û, ,Û, ,Û,Û,Û,Û,Û,Û,Û,Û,Û, ,Û,Û,Û, ,Û,Û,Û,Û,Û, ,Û, ,Û,Û,Û,Û,Û,Û,Û, ,Û
Û, , , , , , , , , ,Û, ,Û, , , ,Û, , , ,Û, , , , , ,Û, , , ,Û, , , ,Û
Û,Û,Û, ,Û,Û,Û, ,Û,Û,Û, ,Û,Û,Û, ,Û, ,Û,Û,Û,Û,Û, ,Û,Û,Û, ,Û,Û,Û, ,Û,Û,Û
Û, , , , , ,Û, , , , , , , ,Û, ,Û, , , , , , , , , , , , , ,Û, , , ,Û
Û, ,Û, ,Û, ,Û, ,Û,Û,Û, ,Û,Û,Û, ,Û, ,Û,Û,Û, ,Û, ,Û,Û,Û, ,Û,Û,Û, ,Û,Û,Û
Û, ,Û, ,Û, ,Û, ,Û, , , , , ,Û, ,Û, ,Û, , , ,Û, ,Û, ,Û, ,Û, , , , , ,Û
Û, ,Û, ,Û, ,Û,Û,Û,Û,Û, ,Û,Û,Û,Û,Û, ,Û,Û,Û,Û,Û, ,Û, ,Û,Û,Û, ,Û, ,Û,Û,Û
Û, ,Û, ,Û, , , , , ,Û, ,Û, , , , , , , ,Û, , , , , ,Û, ,Û, ,Û, , , ,Û
Û,Û,Û, ,Û, ,Û,Û,Û, ,Û,Û,Û, ,Û,Û,Û, ,Û, ,Û,Û,Û,Û,Û,Û,Û, ,Û, ,Û,Û,Û,Û,Û
Û, , , ,Û, , , ,Û, , , ,Û, , , ,Û, ,Û, ,Û, , , , , , , , , , , , , ,Û
Û, ,Û, ,Û, ,Û,Û,Û,Û,Û, ,Û,Û,Û,Û,Û, ,Û, ,Û, ,Û,Û,Û, ,Û, ,Û,Û,Û,Û,Û, ,Û
Û, ,Û, ,Û, , , ,Û, ,Û, , , ,Û, , , ,Û, , , , , ,Û, ,Û, , , , , ,Û, ,Û
Û, ,Û, ,Û, ,Û,Û,Û, ,Û,Û,Û,Û,Û,Û,Û,Û,Û, ,Û,Û,Û, ,Û,Û,Û,Û,Û, ,Û,Û,Û,Û,Û
Û, ,Û, ,Û, , , , , ,Û, ,Û, , , , , , , ,Û, , , , , , , ,Û, ,Û, ,Û, ,Û
Û, ,Û, ,Û,Û,Û,Û,Û, ,Û, ,Û, ,Û, ,Û, ,Û, ,Û,Û,Û, ,Û,Û,Û, ,Û,Û,Û, ,Û, ,Û
Û, ,Û, , , ,Û, , , , , ,Û, ,Û, ,Û, ,Û, , , ,Û, , , ,Û, , , , , ,Û, ,Û
Û,Û,Û,Û,Û, ,Û,Û,Û,Û,Û, ,Û,Û,Û,Û,Û,Û,Û, ,Û, ,Û, ,Û, ,Û, ,Û, ,Û,Û,Û, ,Û
Û, , , , , , , ,Û, ,Û, ,Û, , , ,Û, ,Û, ,Û, ,Û, ,Û, ,Û, ,Û, , , , , ,Û
Û, ,Û,Û,Û, ,Û,Û,Û, ,Û,Û,Û,Û,Û, ,Û, ,Û, ,Û, ,Û, ,Û, ,Û,Û,Û, ,Û,Û,Û, ,Û
Û, ,Û, , , , , , , ,Û, , , , , , , , , ,Û, ,Û, ,Û, , , ,Û, ,Û, ,Û, ,Û
Û,Û,Û,Û,Û, ,Û, ,Û, ,Û,Û,Û,Û,Û, ,Û,Û,Û, ,Û, ,Û,Û,Û,Û,Û,Û,Û,Û,Û, ,Û, ,Û
Û, , , , , ,Û, ,Û, , , ,Û, , , ,Û, , , ,Û, , , , , , , , , ,Û, , , ,Û
Û,Û,Û, ,Û, ,Û, ,Û,Û,Û, ,Û, ,Û,Û,Û,Û,Û,Û,Û, ,Û, ,Û, ,Û,Û,Û,Û,Û, ,Û, ,Û
Û, , , ,Û, ,Û, , , ,Û, ,Û, ,Û, , , , , , , ,Û, ,Û, , , ,Û, , , ,Û, ,Û
Û,Û,Û,Û,Û,Û,Û,Û,Û,Û,Û,Û,Û,Û,Û,Û,Û,Û,Û,Û,Û,Û,Û,Û,Û,Û,Û,Û,Û,Û,Û,Û,Û,Û,Û
